12 10
. . . . . . . . . . . .
~ ~ X . . . . . . . . .
. ~ X ~ . . . . . . . .
. . X . . . . ~ X ~ . .
. m m m . . . . . . . .
. . . . X X m ~ X ~ . .
~ ~ X . . . . . . . . .
. ~ X ~ . . . . X . . .
. . X m m m . X X ~ . .
. m m m . . . . . . . .
